################
#......1.......#
#.#.#.#.#.#.#.##
#..............#
#.#.#.#.#.#.#.##
#..............#
#.#.#.#.#.#.#.##
#..............#
#.#.#.#.#.#.#.##
#.........2....#
#.#.#.#.#.#.#.##
#..............#
################