################################
#......1.......................#
#.#.#.#.#.#.#.#.#.#.#.#.#.#.#.##
#..............................#
#.#.#.#.#.#.#.#.#.#.#.#.#.#.#..#
#..............................#
#.#.#.#.#.#.#.#.#.#.#.#.#.#.#.##
#..............................#
#.#.#.#.#.#.#.#.#.#.#.#.#.#.#.##
#.........2....................#
#.#.#.#.#.#.#.#.#.#.#.#.#.#.#.##
#..............................#
################################