################
#...1..........#
#.#.#.#.#.#.#.##
#..............#
#.#.#.#.#.#.#.##
#..............#
#.#.#.#.#.#.#.##
#..............#
#.#.#.#.#.#.#.##
#.........2....#
#.#.#.#.#.#.#.##
#..............#
################