###############################
#......1......................#
#.#.#.#.#.#.#.#.#.#.#.#.#.#.#.#
#.............................#
#.#.#.#.#.#.#.#.#.#.#.#.#.#.#.#
#.............................#
#.#.#.#.#.#.#.#.#.#.#.#.#.#.#.#
#.............................#
#.#.#.#.#.#.#.#.#.#.#.#.#.#.#.#
#.........2...................#
#.#.#.#.#.#.#.#.#.#.#.#.#.#.#.#
#.............................#
###############################